111111111111111111111111111111111111111111111111111
122222222222222222222222222222222222222222222222221
122222222222222222222322222222222222222222222222221
111111122222222222222222222222222222222222222211111
122222111111222222121111111111111111111111111111111
111122211111112222222222222222222222222222222222211
111111111122222222222222211111111111111111111111111
111111111112222222222222222222222222222221111111111
111111111111111111111111111111111111111111111111111